CambridgeUnionSociety
An Interactive Fiction by Us
Release 1 / Serial number 090510 / Inform 7 build 5U92 (I6/v6.31 lib 6/12N) SD

Presidents Office
A description of the President's office goes here

The president is making paper airplanes out of the Union Constitution.

You can also see a safe (closed) here.

>look at rocket
The Magical Rockets of wootness are fine rockets indeed. Lined with velvet and containing more on the inside than on the, these rockets were famed in the land for their ability to say "Woot".

* * *

CambridgeUnionSociety
An Interactive Fiction by Us
Release 1 / Serial number 090510 / Inform 7 build 5U92 (I6/v6.31 lib 6/12N) SD

Presidents Office
A description of the President's office goes here

The president is making paper airplanes out of the Union Constitution.

You can also see a safe (closed) here.

>take alpaca
Taken.

>inventory
You are carrying:
  an alpaca

>eat alpaca
That's plainly inedible.

>drop alpaca
Dropped.

>throw alpaca
The alpaca is already here.

* * *

CambridgeUnionSociety
An Interactive Fiction by Us
Release 1 / Serial number 090510 / Inform 7 build 5U92 (I6/v6.31 lib 6/12N) SD

Presidents Office
A description of the President's office goes here

The president is making paper airplanes out of the Union Constitution.

You can also see a safe (closed) here.

>take bell
You can't see any such thing.

>open safe
You open the safe, revealing a bell and a hairband.

* * *

CambridgeUnionSociety
An Interactive Fiction by Us
Release 1 / Serial number 090510 / Inform 7 build 5U92 (I6/v6.31 lib 6/12N) SD

Presidents Office
A description of the President's office goes here

The president is making paper airplanes out of the Union Constitution.

You can also see a safe (closed) here.

>take Launchpad
That's hardly portable.

* * *

CambridgeUnionSociety
An Interactive Fiction by Us
Release 1 / Serial number 090510 / Inform 7 build 5U92 (I6/v6.31 lib 6/12N) SD

Presidents Office
A description of the President's office goes here

The president is making paper airplanes out of the Union Constitution.

You can also see a safe (closed) here.

>hi livvy
That's not a verb I recognise.

>say hello to livvy
There is no reply.

>look at livvy
this is a description of the Cambridge Union Society President.

* * *

CambridgeUnionSociety
An Interactive Fiction by Us
Release 1 / Serial number 090510 / Inform 7 build 5U92 (I6/v6.31 lib 6/12N) SD

Presidents Office
A description of the President's office goes here

The president is making paper airplanes out of the Union Constitution.

You can also see a safe (closed) here.

>look at if the president here
I only understood you as far as wanting to look at if The President.

* * *

CambridgeUnionSociety
An Interactive Fiction by Us
Release 1 / Serial number 090510 / Inform 7 build 5U92 (I6/v6.31 lib 6/12N) SD

Presidents Office
A description of the President's office goes here

The president is making paper airplanes out of the Union Constitution.

You can also see a safe (closed) here.

>take inventory
You are carrying nothing.

>inventory
You are carrying nothing.

>look
Rocket
The Magical Rockets of wootness are fine rockets indeed. Lined with velvet and containing more on the inside than on the, these rockets were famed in the land for their ability to say "Woot".

You can see an inventory here.

>eat inventory
(first taking the inventory)
That's plainly inedible.

>inventory
You are carrying:
  an inventory

>drop inventory
Dropped.

>look
Rocket
The Magical Rockets of wootness are fine rockets indeed. Lined with velvet and containing more on the inside than on the, these rockets were famed in the land for their ability to say "Woot".

You can see an inventory here.

* * *

CambridgeUnionSociety
An Interactive Fiction by Us
Release 1 / Serial number 090510 / Inform 7 build 5U92 (I6/v6.31 lib 6/12N) SD

Presidents Office
A description of the President's office goes here

The president is making paper airplanes out of the Union Constitution.

You can also see a safe (closed) here.

>take rocket
That's fixed in place.

>take toy rocket
That's fixed in place.

* * *

CambridgeUnionSociety
An Interactive Fiction by Us
Release 1 / Serial number 090510 / Inform 7 build 5U92 (I6/v6.31 lib 6/12N) SD

Presidents Office
A description of the President's office goes here

The president is making paper airplanes out of the Union Constitution.

You can also see a safe (closed) here.

>look at the safe
 The safe is now open. Inside you see a bell, and a pile of rotting documents. Margaret Thatcher's old hairband is scrumpled in the back corner.

>close the safe
You close the safe.

>look
President's Office
A description of the President's office goes here

The president is making paper airplanes out of the Union Constitution.

You can also see a safe (closed) here.

>look at safe
 Next to the office door is a large black safe. It has old rotting documents in it that no one wants. But it looks impressive, so the officers keep it around. In general, the officers tend to keep things in the office which look impressive but are useless. Except the officers, of course.

* * *

CambridgeUnionSociety
An Interactive Fiction by Us
Release 1 / Serial number 090510 / Inform 7 build 5U92 (I6/v6.31 lib 6/12N) SD

Presidents Office
A description of the President's office goes here

The president is making paper airplanes out of the Union Constitution.

You can also see a safe (closed) here.

>eat the rocket
(first taking the Toy Rocket)
Rockets do indeed taste good, but what will you say when your boss comes back and asks you what you did with it? Your dog is not here, so you can't blame it on him.

* * *

CambridgeUnionSociety
An Interactive Fiction by Us
Release 1 / Serial number 090510 / Inform 7 build 5U92 (I6/v6.31 lib 6/12N) SD

Presidents Office
A description of the President's office goes here

The president is making paper airplanes out of the Union Constitution.

You can also see a safe (closed) here.

>take launchpad
That's fixed in place.

* * *

CambridgeUnionSociety
An Interactive Fiction by Us
Release 1 / Serial number 090510 / Inform 7 build 5U92 (I6/v6.31 lib 6/12N) SD

Presidents Office
A description of the President's office goes here

The president is making paper airplanes out of the Union Constitution.

You can also see a safe (closed) here.

>look at safe
Next to the office door is a large black safe. It has old rotting documents in it that no one wants. But it looks impressive, so the officers keep it around. In general, the officers tend to keep things in the office which look impressive but are useless. Except the officers, of course.

>open safe
You open the safe, revealing a bell and a hairband.

>look
President's Office
A description of the President's office goes here

The president is making paper airplanes out of the Union Constitution.

You can also see a safe (empty) here.

>look at safe
 The safe is now open. Inside you see a bell, and a pile of rotting documents. Margaret Thatcher's old hairband is scrumpled in the back corner.

* * *

>open safe
You open the safe, revealing a bell and a hairband.

>take bell
The President sees your theft and leaves in a blur of red tape.

>restart
Are you sure you want to restart?

* * *

>take bell
The President sees your theft and leaves in a blur of red tape.

>w
Reception
A maze of activity, the office is strewn with printouts, computers, old copies of books and periodicals, and the occasional debater.

The President is reporting your theft of the bell on a tedious form.

>look at president
This is a description of the Cambridge Union Society President.

* * *

CambridgeUnionSociety
An Interactive Fiction by Us
Release 1 / Serial number 090510 / Inform 7 build 5U92 (I6/v6.31 lib 6/12N) SD

Presidents Office
A description of the President's office goes here

The president is making paper airplanes out of the Union Constitution.

You can also see a safe (closed) here.

>open safe
You open the safe, revealing a bell and a hairband.

* * *

>take bell
The President sees your theft and leaves in a blur of red tape.

>drop bell
Dropped.

>taek bell
That's not a verb I recognise.

>take bell
The President sees your theft and leaves in a blur of red tape.

>look
Presidents Office
A description of the President's office goes here

You can see a safe (in which is a hairband) here.

>w
Reception
A maze of activity, the office is strewn with printouts, computers, old copies of books and periodicals, and the occasional debater.

The President is reporting your theft of the bell on a tedious form.

>drop bell
Dropped.

* * *

CambridgeUnionSociety
An Interactive Fiction by Us
Release 1 / Serial number 090510 / Inform 7 build 5U92 (I6/v6.31 lib 6/12N) SD

Presidents Office
A description of the President's office goes here

The president is making paper airplanes out of the Union Constitution.

You can also see a safe (closed) here.

>look
President's Office
A description of the President's office goes here

The president is making paper airplanes out of the Union Constitution.

You can also see a safe (closed) here.

>open safe
You open the safe, revealing a bell and a hairband.

>look
President's Office
A description of the President's office goes here

The president is making paper airplanes out of the Union Constitution.

You can also see a safe (in which are a bell and a hairband) here.

>look at the president
This is a description of the Cambridge Union Society President.

* * *

>look at the president
You can't see any such thing.

>look
President's Office
A description of the President's office goes here

You can see a safe (in which is a hairband) here.

>take hairband
You reach out for the hairband, and are racked with pangs of guilt. You feel Margaret Thatcher watching you from across the generations. She cannot approve. You draw your hand back again, thoroughly freaked out.

>w
Reception
A maze of activity, the office is strewn with printouts, computers, old copies of books and periodicals, and the occasional debater.

The president is making paper airplanes out of the Union Constitution.

* * *

>open safe
You open the safe, revealing a bell and a hairband.

>take bell
Taken.

>look at bell
It is a bell. Ask not for whom it tolls.

>for whom does it toll?
That's not a verb I recognise.

>take hairband
 Livvy looks at you pointedly. "that hairband has been there for millenia, it is a very famous hairband and I can't be responsible for what happens if it's lost ".

* * *

>look
President's Office
A description of the President's office goes here

The president is making paper airplanes out of the Union Constitution.

You can also see a safe (closed) here.

>down
Launchpad
This is a very ordinary launchpad, containing mundane things like espresso bars and pingpong tables. One pingpong table is blue.

>up
Rocket

* * *

>look
President's Office
A description of the President's office goes here

The president is making paper airplanes out of the Union Constitution.

You can also see a safe (closed) here.

>look at launchpad
This is a very ordinary launchpad, containing mundane things like espresso bars and pingpong tables. One pingpong table is blue.

>look at rocket
You see nothing special about the Rocket.